NO assets/textures/eagle.xpm
SO ./assets/textures/redbrick.xpm
WE ./assets/textures/mossy.xpm
EA ./assets/textures/wood.xpm

C 0,255,255 
  F 255,0,255

         1
        101
       10001
      1000001
     100000001
    10000000001
   1000000000001
  100000000000001
 10000000000000001
100000000N000000001
 10000000000000001
  100000000000001
   1000000000001
    10000000001
     100000001
      1000001
       10001
        101
         1
